NO ./png/no.png
SO ./png/so.png
WE ./png/we.png
EA ./png/ea.png
F 225, 5, 6
C 225,30,0


1111111111111111111111111111
1000000000100000000000000101
1000000000100000000000000101
1000000000100000000000000101
1000000000100000000000000001
1000000000100000101100000101
1000000000111111100000000101
1000000000000000000100000001
1000000000000000000000000001
1000000000000000000000000001
1000000000000N00000000000001
1000000000000000000000000001
1111111111111111111111111111