NO ./png/no.png
SO ./png/so.png
WE ./png/we.png
EA ./png/ea.png
F 225, 5, 6
C 225,30,0

1111111111111111111111111111111111111111111111111111111111111111111111111111111111111111111
1000000000000000000000000000000000000000000000000000000000000000000000000000000000000000001
11111111111111111111111D111111111111111111111111111111111D111111111111111111111111111111101
                      101                               101                             101
                      101                               101                             101
          1111111111111D11111111111111111111            101                             101
          100000000000D0D0000000000000000001            101                             101
          1011111111111D11111111111111111101            1D1                             101
          101         101                101            101                             101
          101         101                101            101                             101
11111111111D11111111111D111111111111111111D111111111111110111                           111
1000000000100000000000000100000000000000000000000000000000001                           101
10000000001000000000000001000000000000000000000000000000000011111111111111111111111111111D1
100000000010000000000000010000000000000000000000000000000000D000000000000000000000000000001
10000000001000000000000001000000000000000000000000000000000011111111111111111111111111111D1
1000000000100000000000000100000000000000000000000000000000001                           101
1000000000100000000000000D00000000000000000000000000000000001                           101
10000000001000001D110000010000000000S000000000000000000000001                           101
1000000000111111100D00000100000000000000000000000000000000001                           101
1000000000000000000100000000000000000000000000000000000000001                           101
1000000000000000000000000001000000000000000000000000000000001                           101
1000000000000000000000000001000000000000000000000000000000001                           101
1000000000000000000000000001000000111111111110000000000000001                           101
1000000000000000000000000001000000000000000000000000000000001                           101
1000000000000000000000001001000000000000000000000000000000001                           101
1000000000000000000000000001000000000000000000000000000000001                           101
1000000000000000000000000001000000000000000000000000000000001                           101
1000000000000000000000000001000000000000000000000000000000001                           101
10000000000000000000000000010000000000000000000000000000000011111111111111111111111111111D1
100000000000000000000000000000000000000000000000000000000000D000000000000000000000000000001
1111111111111111111111111111111111111111111111111111111111111111111111111111111111111111111