NO ./png/no.png
SO ./png/so.png
WE ./png/we.png
EA ./png/ea.png
F 119, 127, 122
C 0, 14, 5


        1111111111111111111111111
        1000000000110000000000001
        1011000001110000000000001
        1001000000000000000000001
111111111011000001110000000000001
100000000011000001110111111111111
11110111111111011100000010001
11110111111111011101010010001
11111111111111111100000000001
1000000000000000110000001N001
10000000000000001101010010001
1100000111010101111101111000111
11110111 1110101 101111010001
11111111 1111111 111111111111