              NO ./door.png
 SO         ./door.png
WE                                 ./door.png


                               F             124 ,             221    ,         34             
          C 5,        25,          55    
                            EA ./door.png

11111
1N001
10001
11111