NO /Mandatory/Images/5.png
SO /Mandatory/Images/2.png
WE /Mandatory/Images/3.png
EA /Mandatory/Images/4.png
F 21,144,0
C 215,35,0

111111111111111111111111111111111
1111111111111111111110000000000001
         1011000001110000000000001
         10010000000000000000000011111111
111111111011000001110000000000001
1000000000110000000110111111111111
11110111111111011100000010001
1111011111111101110101000001
1100000011010101110000000001
10000000000000001100000010001
10000000000000001101010010001
11000001110101011111011110S0111
1111011111101011011110100011
11111111111111111111111111
