11111111111111111111111111111111
10010000000000E00000000011111111
11111111101100000111000000000001
10000000001100000111011111111111
11110111111111011100000010000011
11110111111111011101010010000001
11000000110101011100000010000011
10000000000000001100000010000011
10000000000000001101010010000001
11000001110111111111111000110001
11110111111010110111101000000001
11111111111111111111111111111111