NO Images/5.png
SO Images/2.png
WE Images/3.png
EA Images/4.png
F 101,144,0
C 225,35,0

1111111111111111111111111
1000000000110000000000001
101100000111000000N000001
1001000000000000000000001
1111111110110000011100001
1000000000110000000110111
1111011111111101110000001
1111011111111101110101001
1100000011010101110000001
1000000000000000110000001
1000000000000000110101001
1100000111010101111101111
1111011111101011011110111
1111111111111111111111111