

C 225,35   , 01

NO Mandatory/Images/5.png
                SO                       Mandatory/Images/2.png
WE Mandatory/Images/3.png
                EA Mandatory/Images/4.png
F 101, 144,0001 

            1111111111      
            100000S01    
11111111111111101111
1111111111111111111