
  
  
              NO Bonus/Images/5.png
 SO                     Bonus/Images/2.png
                               F 00 ,0,0    


WE                                         Bonus/Images/3.png


          C 5,        25,          55    
                            EA Bonus/Images/4.png

1111111111111111111111111
1000000000110000000000001
1011000001110000000000001
10010000000000000000000011111111
111111111011000001110000000000001
1000000000110000000110111111111111
10010000000000000000000011111111
111111111011000001110000000000001
10000000001100000001101111111111111
111111111011000001110000000000001
10000000001100000001101111111111111
111111111011000001110000000000001
10000000001100000001101111111111111
111111111011000001110000000000001
1000000000110000000110111111111111
11110111111111011100000010001
1111011111111101110101000001
1100000011010101110000000001
10000000000000001100000010001
10000000000000001101010010001
11000001110101011111011110N0111
11110111 1110101 101111010001
11111111 1111111 111111111111