              NO Bonus/Images/5.png
 SO         Bonus/Images/8.png
WE                                 Bonus/Images/9.png


                               F             012 ,             021    ,         34             
          C 5,        25,          55    
                            EA Bonus/Images/2.png


1111111111111111111111111
1000000000000000000000001
1000000000000000000000001
1000000000000000000000001
1000000000000000000000001
1000000000000000000000001
1000000000000000000000001
1000000000000000000000001
1000000000000000111111111
10000000000E0000D00000001
1000000000000000100000001
1111111111111111111111111