              NO Bonus/Images/5.png
 SO         Bonus/Images/8.png
WE                                 Bonus/Images/9.png


                               F             012 ,             021    ,         34             
          C 5,        25,          55    
                            EA Bonus/Images/7.png

111111111111111111111111111111111111111111111
100000000000000000000000000000000000000000001
100000000000000000000000000000000000000000001
100000000000000000000000000000000000000000001
100000000000000000000000000000000000000000001
100000000000000000000000000000000000000000001
100000000000000000000000000000000000000000001
100000000000000000000000000000000000000000001
100000000000000000000000000000000000000000001
100000000000000000000000000000000000000000001
100000000000000000000000000000000000000000001
100000000000000000000000000000000000000000001
1000000000000000000000000000000000000S0000001
100000000000000000000000000000000100000000001
100000000000000000000000000000000D00000000001
100000000000000000000000000000000111111111111
100000000000000000000000000000000000000000001
100000000000000000000000000000000000000000001
100000000000000000000000000000001111111111111
100000000000000000000000000000000000000000001
111111111111111111111111111111111111111111111