              NO Bonus/Images/5.png
 SO         Bonus/Images/8.png
WE                                 Bonus/Images/9.png


                               F             012 ,             021    ,         34             
          C 5,        25,          55    
                            EA Bonus/Images/2.png


1111111111111111111111111
1000000000000000000000001
1000000000000000000000001
1000000000000000000000001
1000000000000000000000001
1000000000000001000000001
1000000000000010000000101
1000000000000011000000001
1000111111111000111111111
10000000000E0010000000001
1000000001000000100000001
1111111111111111111111111